NO ./textures/mossy.xpm
SO ./textures/redbrick.xpm
WE ./textures/stone.xpm
EA ./textures/wood.xpm

F 184,113,39
C 51,198,227

11111111111111111111111111111
10000000001100000000000000001
10110000011100000000000010001
10010000000000000000000010001
10110000011100000000000010001
10000000001100000111011110001
11110111111111011100000010001
11110111111111011111010010001
11000000110101011100000010001
10000000000000001100000010001
10000000000000001101010010001
11000000110101000000000000001
11110111110101000000101000001
10000000001100000100000010001
10000000000000001000000001001
10000000001000010001010001001
10000000001101000000N10000001
10000000000100000001010000001
11111111111111111111111111111



